[
  {
    "type": "effect_on_condition",
    "id": "EOC_RandEnc_VC_Shoppers_add",
    "//": "Adds random survivors visiting the valhallist warehouse to shop",
    "recurrence": 3000,
    "global": true,
    "condition": {
      "and": [
        { "u_near_om_location": "valhallist_left_corner_up", "range": 30 },
        { "not": { "u_near_om_location": "valhallist_left_corner_up", "range": 2 } },
        "is_day",
        { "one_in_chance": 10 },
        {
          "not": { "u_compare_time_since_var": "RandEnc", "type": "timer", "context": "VC_Shoppers", "op": "<", "time": "1 d" }
        }
      ]
    },
    "effect": [
      { "mapgen_update": "nest_RandEnc_RC_Shoppers_add", "om_terrain": "valhallist_left_corner_up" },
      { "u_add_var": "RandEnc", "type": "timer", "context": "VC_Shoppers", "time": true },
      {
        "u_location_variable": { "global_val": "randenc_shoppers_loc" },
        "target_params": { "om_terrain": "valhallist_left_corner_up" }
      },
      { "arithmetic": [ { "global_val": "var", "var_name": "VC_Shoppers_visiting" }, "=", { "const": 1 } ] }
    ]
  },
  {
    "type": "effect_on_condition",
    "id": "EOC_RandEnc_VC_Shoppers_remove",
    "recurrence": 200,
    "global": true,
    "condition": {
      "and": [
        {
          "or": [
            { "u_compare_time_since_var": "RandEnc", "type": "timer", "context": "VC_Shoppers", "op": ">", "time": "6 h" },
            "is_night"
          ]
        },
        { "compare_num": [ { "global_val": "var", "var_name": "VC_Shoppers_visiting" }, "==", { "const": 1 } ] },
        { "not": { "u_near_om_location": "valhallist_left_corner_up", "range": 2 } }
      ]
    },
    "effect": [
      {
        "mapgen_update": "nest_RandEnc_RC_Shoppers_remove",
        "om_terrain": "valhallist_left_corner_up",
        "target_var": { "global_val": "randenc_shoppers_loc" }
      },
      { "arithmetic": [ { "global_val": "var", "var_name": "VC_Shoppers_visiting" }, "=", { "const": 0 } ] }
    ]
  },
  {
    "type": "mapgen",
    "method": "json",
    "update_mapgen_id": "nest_RandEnc_VC_Shoppers_add",
    "//": "Adds a random NPC to the warehouse, placed off in the corner.",
    "object": { "place_npcs": [ { "class": "RC_survivor_visiting", "x": 21, "y": 8 } ] }
  },
  {
    "type": "mapgen",
    "method": "json",
    "update_mapgen_id": "nest_RandEnc_VC_Shoppers_remove",
    "//": "Adds a random NPC to the warehouse, placed off in the corner.",
    "object": { "remove_npcs": [ { "class": "RC_survivor_visiting", "x": 0, "y": 0 } ] }
  },
  {
    "type": "mapgen",
    "method": "json",
    "nested_mapgen_id": "bicycle_spawn",
    "object": {
      "mapgensize": [ 3, 3 ],
      "faction_owner": [ { "id": "your_followers", "x": [ 0, 3 ], "y": [ 0, 3 ] } ],
      "place_vehicles": [ { "vehicle": "bicycle", "x": 2, "y": 2, "chance": 100, "status": 0 } ]
    }
  },
  {
    "type": "mapgen",
    "method": "json",
    "nested_mapgen_id": "bicycle_dirt_spawn",
    "object": {
      "mapgensize": [ 3, 3 ],
      "faction_owner": [ { "id": "your_followers", "x": [ 0, 3 ], "y": [ 0, 3 ] } ],
      "place_vehicles": [ { "vehicle": "bicycle_dirt", "x": 2, "y": 2, "chance": 100, "status": 0 } ]
    }
  },
  {
    "type": "mapgen",
    "method": "json",
    "nested_mapgen_id": "bicycle_electric_spawn",
    "object": {
      "mapgensize": [ 3, 3 ],
      "faction_owner": [ { "id": "your_followers", "x": [ 0, 3 ], "y": [ 0, 3 ] } ],
      "place_vehicles": [ { "vehicle": "bicycle_electric", "x": 2, "y": 2, "chance": 100, "status": 0 } ]
    }
  },
  {
    "type": "mapgen",
    "method": "json",
    "nested_mapgen_id": "motorcycle_enduro_spawn",
    "object": {
      "mapgensize": [ 3, 3 ],
      "faction_owner": [ { "id": "your_followers", "x": [ 0, 3 ], "y": [ 0, 3 ] } ],
      "place_vehicles": [ { "vehicle": "motorcycle_enduro", "x": 2, "y": 2, "chance": 100, "status": 0 } ]
    }
  },
  {
    "type": "mapgen",
    "method": "json",
    "nested_mapgen_id": "motorcycle_sidecart_spawn",
    "object": {
      "mapgensize": [ 3, 3 ],
      "faction_owner": [ { "id": "your_followers", "x": [ 0, 3 ], "y": [ 0, 3 ] } ],
      "place_vehicles": [ { "vehicle": "motorcycle_sidecart", "x": 2, "y": 2, "chance": 100, "status": 0 } ]
    }
  },
  {
    "type": "mapgen",
    "method": "json",
    "nested_mapgen_id": "scooter_spawn",
    "object": {
      "mapgensize": [ 3, 3 ],
      "faction_owner": [ { "id": "your_followers", "x": [ 0, 3 ], "y": [ 0, 3 ] } ],
      "place_vehicles": [ { "vehicle": "scooter", "x": 2, "y": 2, "chance": 100, "status": 0 } ]
    }
  },
  {
    "type": "mapgen",
    "method": "json",
    "nested_mapgen_id": "scooter_electric_spawn",
    "object": {
      "mapgensize": [ 3, 3 ],
      "faction_owner": [ { "id": "your_followers", "x": [ 0, 3 ], "y": [ 0, 3 ] } ],
      "place_vehicles": [ { "vehicle": "scooter_electric", "x": 2, "y": 2, "chance": 100, "status": 0 } ]
    }
  },
  {
    "type": "mapgen",
    "method": "json",
    "om_terrain": [ "valhallist_enter" ],
    "weight": 100,
    "object": {
      "faction_owner": [ { "id": "valhallists", "x": [ 0, 23 ], "y": [ 0, 23 ] } ],
      "fill_ter": "t_dirt",
      "rows": [
        "                        ",
        "                  ##### ",
        "  #####           #S+T# ",
        "  #...+           +.### ",
        "  #T.S#           #.+T# ",
        "  #####           ##### ",
        "                        ",
        " $    $           0   0 ",
        "                        ",
        " $    $           0   0 ",
        "                        ",
        " $    $           0   0 ",
        "                        ",
        " $    $           0   0 ",
        "                        ",
        " $    $           0   0 ",
        "                        ",
        " $    $           0   0 ",
        "       !       x!       ",
        "########pppppppP########",
        "       !       x!       ",
        "                        ",
        "                        ",
        "                        "
      ],
      "palettes": [ "bandit_camp" ],
      "npcs": { "!": { "class": "pagan_cult_member" } },
      "terrain": { " ": "t_region_groundcover", ".": "t_rock_floor", "S": "t_rock_floor", "T": "t_rock_floor" },
      "furniture": { "0": "f_training_dummy_heavy", "$": "f_training_dummy_light", "S": "f_sink", "T": "f_toilet" }
    }
  },
  {
    "type": "mapgen",
    "method": "json",
    "om_terrain": [ "valhallist_right_corner" ],
    "weight": 100,
    "object": {
      "faction_owner": [ { "id": "valhallists", "x": [ 0, 23 ], "y": [ 0, 23 ] } ],
      "fill_ter": "t_rock_floor",
      "rows": [
        "                       #",
        "        !n!            #",
        "                       #",
        "  ####+#### ####+####  #",
        "  #nh....o# #nh....o#  #",
        "  #1..d.@@# #1..d.@@#  #",
        "  ######### #########  #",
        "                       #",
        "  ####+#### ####+####  #",
        "  #nh..!.o# #nh....o#  #",
        "  #1..d.@@# #1..d.@@#  #",
        "  ######### #########  #",
        "                       #",
        "  ####+#### ####+####  #",
        "  #nh....o# #nh..!.o#  #",
        "  #1..d.@@# #1..d.@@#  #",
        "  ######### #########  #",
        "                       #",
        "                       #",
        "########################",
        "                        ",
        "                        ",
        "                        ",
        "                        "
      ],
      "palettes": [ "bandit_camp" ],
      "npcs": { "!": { "class": "pagan_cult_member" } },
      "terrain": { " ": "t_region_groundcover", ".": "t_rock_floor", "!": "t_region_groundcover", "n": "t_region_groundcover" },
      "furniture": { "1": "f_firefly_terrarium" }
    }
  },
  {
    "type": "mapgen",
    "method": "json",
    "om_terrain": [ "valhallist_left_corner" ],
    "weight": 100,
    "object": {
      "faction_owner": [ { "id": "valhallists", "x": [ 0, 23 ], "y": [ 0, 23 ] } ],
      "fill_ter": "t_rock_floor",
      "rows": [
        "#                       ",
        "#                       ",
        "#                       ",
        "# ####+#### ####+####   ",
        "# #nh....o# #nh....o#   ",
        "# #1..d.@@# #1..d.@@#   ",
        "# ######### #########   ",
        "#                       ",
        "# ####+#### ####+####   ",
        "# #nh..!.o# #nh....o#   ",
        "# #1..d.@@# #1..d.@@#   ",
        "# ######### #########   ",
        "#                       ",
        "# ####+#### ####+####   ",
        "# #nh....o# #nh..!.o#   ",
        "# #1..d.@@# #1..d.@@#   ",
        "# ######### #########   ",
        "#                       ",
        "#                       ",
        "########################",
        "                        ",
        "                        ",
        "                        ",
        "                        "
      ],
      "palettes": [ "bandit_camp" ],
      "npcs": { "!": { "class": "pagan_cult_member" } },
      "terrain": { " ": "t_region_groundcover", ".": "t_rock_floor" },
      "furniture": { "1": "f_firefly_terrarium" }
    }
  },
  {
    "type": "mapgen",
    "method": "json",
    "om_terrain": [ "valhallist_right_corner_up" ],
    "weight": 100,
    "object": {
      "faction_owner": [ { "id": "valhallists", "x": [ 0, 23 ], "y": [ 0, 23 ] } ],
      "fill_ter": "t_rock_floor",
      "rows": [
        "########################",
        "                       #",
        "                       #",
        "  ####+#### ####+####  #",
        "  #nh....o# #nh....o#  #",
        "  #1..d.@@# #1..d.@@#  #",
        "  ######### #########  #",
        "                       #",
        "  ####+#### ####+####  #",
        "  #nh..!.o# #nh....o#  #",
        "  #1..d.@@# #1..d.@@#  #",
        "  ######### #########  #",
        "                       #",
        "  ####+#### ####+####  #",
        "  #nh....o# #nh..!.o#  #",
        "  #1..d.@@# #1..d.@@#  #",
        "  ######### #########  #",
        "                       #",
        "  ####+#### ####+####  #",
        "  #nh....o# #nh..!.o#  #",
        "  #1..d.@@# #1..d.@@#  #",
        "  ######### #########  #",
        "                       #",
        "                       #"
      ],
      "palettes": [ "bandit_camp" ],
      "npcs": { "!": { "class": "pagan_cult_member" } },
      "terrain": { " ": "t_region_groundcover", ".": "t_rock_floor" },
      "furniture": { "1": "f_firefly_terrarium" }
    }
  },
  {
    "type": "mapgen",
    "method": "json",
    "om_terrain": [ "valhallist_left_corner_up" ],
    "weight": 100,
    "object": {
      "faction_owner": [ { "id": "valhallists", "x": [ 0, 23 ], "y": [ 0, 23 ] } ],
      "fill_ter": "t_rock_floor",
      "rows": [
        "########################",
        "#                       ",
        "#                       ",
        "#  ####+###+##########  ",
        "#  #L2o.ooo.r.r2r.r.r#  ",
        "#  #L.o.....r.r.r.r.r#  ",
        "#  #L.1..2..r.1.1.r.1#  ",
        "#  #L...............r#  ",
        "#  #L.1.....r.1.1.r.1#  ",
        "#  #L.o..1..r.r.r.r2r#  ",
        "#  #L.o.....r.r#######  ",
        "#  #L.1..2..r.r#33333#  ",
        "#  #2..........+..!.3#  ",
        "#  #LLL..1..LLL#]]]]]#  ",
        "#  #2.........2#.....#  ",
        "#  #LLLLLLLLLLL#hnh..#  ",
        "#  ################+##  ",
        "#                       ",
        "#                       ",
        "#                       ",
        "#                       ",
        "#                       ",
        "#                       ",
        "#                       "
      ],
      "palettes": [ "bandit_camp" ],
      "npcs": { "!": { "class": "pagan_cult_shopkeep" }, "2": { "class": "pagan_cult_member" } },
      "terrain": { " ": "t_region_groundcover", ".": "t_rock_floor", "]": "t_bars" },
      "furniture": { "1": "f_firefly_terrarium", "3": "f_rack_wood", "L": "f_rack_wood", "r": "f_rack_wood" },
      "place_zones": [
        {
          "type": "LOOT_ITEM_GROUP",
          "filter": "valhallist_shopkeep_0",
          "faction": "valhallists",
          "x": [ 16, 20 ],
          "y": [ 11, 11 ]
        },
        {
          "type": "LOOT_ITEM_GROUP",
          "filter": "valhallist_shopkeep_1",
          "faction": "valhallists",
          "x": [ 16, 20 ],
          "y": [ 11, 11 ]
        },
        {
          "type": "LOOT_ITEM_GROUP",
          "filter": "valhallist_weapons",
          "faction": "valhallists",
          "x": [ 16, 20 ],
          "y": [ 11, 11 ]
        },
        { "type": "LOOT_UNSORTED", "faction": "valhallists", "x": [ 20, 20 ], "y": [ 12, 12 ] }
      ],
      "items": {
        "L": [
          { "item": "condiments", "chance": 40, "repeat": [ 1, 2 ] },
          { "item": "groce_ingredient", "chance": 40, "repeat": [ 1, 2 ] },
          { "item": "groce_bread", "chance": 40, "repeat": [ 1, 2 ] },
          { "item": "pantry_liquids", "chance": 40, "repeat": [ 1, 2 ] },
          { "item": "dry_goods", "chance": 40, "repeat": [ 1, 2 ] },
          { "item": "preserved_food", "chance": 40, "repeat": [ 1, 2 ] }
        ],
        "o": [
          { "item": "homebooks", "chance": 80, "repeat": [ 1, 2 ] },
          { "item": "manuals", "chance": 80, "repeat": [ 1, 2 ] },
          { "item": "textbooks", "chance": 80, "repeat": [ 1, 2 ] }
        ],
        "r": [
          { "item": "hardware_bulk", "chance": 80, "repeat": [ 2, 4 ] },
          { "item": "plumbing_bulk", "chance": 80, "repeat": [ 2, 4 ] },
          { "item": "wood_workshop", "chance": 80, "repeat": [ 2, 4 ] },
          { "item": "supplies_hardware", "chance": 80, "repeat": [ 2, 4 ] },
          { "item": "supplies_farming", "chance": 80, "repeat": [ 2, 4 ] },
          { "item": "supplies_fuel", "chance": 80, "repeat": [ 2, 4 ] },
          { "item": "supplies_metal", "chance": 80, "repeat": [ 2, 4 ] }
        ]
      }
    }
  },
  {
    "type": "mapgen",
    "method": "json",
    "om_terrain": [ "valhallist_long_wall" ],
    "//": "Garage",
    "weight": 100,
    "object": {
      "faction_owner": [ { "id": "valhallists", "x": [ 0, 23 ], "y": [ 0, 23 ] } ],
      "fill_ter": "t_dirt",
      "rows": [
        "#                       ",
        "#    ###...###          ",
        "#    #T+...+T#          ",
        "#    ###S.S###          ",
        "#    #T+...+T#          ",
        "#    ###S.S###          ",
        "#    #T+...+T#          ",
        "#    #########          ",
        "#                !      ",
        "#     #.........#       ",
        "#     #1.........       ",
        "#     #r.........       ",
        "#     #r2........       ",
        "#     #r.........       ",
        "#     #1.........       ",
        "#     #.........#       ",
        "#               !       ",
        "#                       ",
        "#                       ",
        "#                       ",
        "#                       ",
        "#                       ",
        "#                       ",
        "#                       "
      ],
      "palettes": [ "bandit_camp" ],
      "npcs": { "!": { "class": "pagan_cult_member" }, "2": { "class": "pagan_cult_mechanic" } },
      "terrain": { " ": "t_region_groundcover", ".": "t_rock_floor", "2": "t_rock_floor", "S": "t_rock_floor", "T": "t_rock_floor" },
      "furniture": { "1": "f_firefly_terrarium", "r": "f_rack", "S": "f_sink", "T": "f_toilet" },
      "items": {
        "r": [
          { "item": "hardware_bulk", "chance": 80, "repeat": [ 2, 4 ] },
          { "item": "supplies_fuel", "chance": 80, "repeat": [ 2, 4 ] },
          { "item": "supplies_metal", "chance": 80, "repeat": [ 2, 4 ] }
        ]
      }
    }
  },
  {
    "type": "mapgen",
    "method": "json",
    "om_terrain": [ "valhallist_long_wall" ],
    "//": "garden",
    "weight": 70,
    "object": {
      "faction_owner": [ { "id": "valhallists", "x": [ 0, 23 ], "y": [ 0, 23 ] } ],
      "fill_ter": "t_dirt",
      "rows": [
        "#                       ",
        "#                 !     ",
        "#    DD DD   DD DD      ",
        "#    DD DD   DD DD      ",
        "#    DD DD   DD DD      ",
        "#    DD DD   DD DD      ",
        "#    DD DD   DD DD      ",
        "#    DD DD   DD DD      ",
        "#    DD DD  !DD DD      ",
        "#    DD DD   DD DD      ",
        "#    DD DD   DD DD      ",
        "#    DD DD   DD DD      ",
        "#    DD DD   DD DD      ",
        "#    DD DD   DD DD      ",
        "#    DD DD   DD DD      ",
        "#    DD DD   DD DD      ",
        "#    DD DD   DD DD      ",
        "#    DD DD   DD DD      ",
        "#    DD DD   DD DD      ",
        "#    DD DD   DD DD      ",
        "#   !DD DD   DD DD      ",
        "#                       ",
        "#                       ",
        "#                       "
      ],
      "palettes": [ "bandit_camp" ],
      "sealed_item": { "D": { "item": { "item": "seed_corn" }, "furniture": "f_plant_seedling", "chance": 70 } },
      "npcs": { "!": { "class": "pagan_cult_member" } },
      "terrain": { " ": "t_region_groundcover", "D": "t_dirtmound" }
    }
  },
  {
    "type": "mapgen",
    "method": "json",
    "om_terrain": [ "valhallist_longhouse" ],
    "weight": 100,
    "object": {
      "faction_owner": [ { "id": "valhallists", "x": [ 0, 23 ], "y": [ 0, 23 ] } ],
      "fill_ter": "t_rock_floor",
      "rows": [
        "########################",
        "                        ",
        "                        ",
        "                        ",
        "                        ",
        "                        ",
        "       ##############   ",
        "       #@@1.hnh.1#.T#   ",
        "       #@@.......+..#   ",
        "       #######+###1S#   ",
        "       #!...1...!####   ",
        "       #....2....#      ",
        "       #.........#      ",
        "       #1.......1#      ",
        "       #.........#      ",
        "       #.........#      ",
        "       #!.1...1.!#      ",
        "       ####+++####      ",
        "                        ",
        "                        ",
        "                        ",
        "                        ",
        "                        ",
        "                        "
      ],
      "palettes": [ "bandit_camp" ],
      "npcs": { "!": { "class": "pagan_cult_member" }, "2": { "class": "pagan_cult_leader" } },
      "terrain": { " ": "t_region_groundcover" },
      "furniture": { "1": "f_firefly_terrarium", "2": "f_chair", "S": "f_sink", "T": "f_toilet" }
    }
  },
  {
    "type": "mapgen",
    "method": "json",
    "om_terrain": [ "valhallist_henge" ],
    "weight": 100,
    "object": {
      "faction_owner": [ { "id": "valhallists", "x": [ 0, 23 ], "y": [ 0, 23 ] } ],
      "fill_ter": "t_dirt",
      "rows": [
        "                        ",
        "               ...      ",
        "               .~!..    ",
        "    ....        ....    ",
        "    .~.......   ....    ",
        " ....!   ....     ....  ",
        " ...... ......  ........",
        "  ....................~.",
        "  .~........~...........",
        " ..........ss...p.....  ",
        " ........~ssssss....... ",
        "     ..sssssssss.....   ",
        "   ..pssss2npsss.~..... ",
        " ......sssssssss.....~. ",
        " .~.....~ss#sssp.....!. ",
        " .......ss..ss.......   ",
        "   .......p!......      ",
        "  ..................    ",
        "   .................... ",
        "  ...~..  ...........~. ",
        "   .....   ......   ... ",
        "           ....~..      ",
        "             .....      ",
        "                        "
      ],
      "palettes": [ "bandit_camp" ],
      "npcs": { "!": { "class": "pagan_cult_member" }, "2": { "class": "pagan_cult_gode" } },
      "terrain": {
        " ": "t_region_groundcover",
        "s": "t_grass",
        ".": [ "t_region_soil", "t_region_groundcover" ],
        "p": "t_grass",
        "#": "t_grass"
      },
      "furniture": { "2": "f_chair", "p": "f_boulder_large", "~": "f_boulder_small", "#": "f_brazier" }
    }
  },
  {
    "type": "mapgen",
    "update_mapgen_id": "valhallist_place_bicycle",
    "method": "json",
    "object": { "place_nested": [ { "chunks": [ "bicycle_spawn" ], "x": 13, "y": 11 } ] }
  },
  {
    "type": "mapgen",
    "update_mapgen_id": "valhallist_place_bicycle_dirt",
    "method": "json",
    "object": { "place_nested": [ { "chunks": [ "bicycle_dirt_spawn" ], "x": 13, "y": 11 } ] }
  },
  {
    "type": "mapgen",
    "update_mapgen_id": "valhallist_place_bicycle_electric",
    "method": "json",
    "object": { "place_nested": [ { "chunks": [ "bicycle_electric_spawn" ], "x": 13, "y": 11 } ] }
  },
  {
    "type": "mapgen",
    "update_mapgen_id": "valhallist_place_motorcycle_enduro",
    "method": "json",
    "object": { "place_nested": [ { "chunks": [ "motorcycle_enduro_spawn" ], "x": 13, "y": 11 } ] }
  },
  {
    "type": "mapgen",
    "update_mapgen_id": "valhallist_place_motorcycle_sidecart",
    "method": "json",
    "object": { "place_nested": [ { "chunks": [ "motorcycle_sidecart_spawn" ], "x": 13, "y": 11 } ] }
  },
  {
    "type": "mapgen",
    "update_mapgen_id": "valhallist_place_scooter",
    "method": "json",
    "object": { "place_nested": [ { "chunks": [ "scooter_spawn" ], "x": 13, "y": 11 } ] }
  },
  {
    "type": "mapgen",
    "update_mapgen_id": "valhallist_place_scooter_electric",
    "method": "json",
    "object": { "place_nested": [ { "chunks": [ "scooter_electric_spawn" ], "x": 13, "y": 11 } ] }
  },
  {
    "type": "mapgen",
    "update_mapgen_id": "valhallist_remove_raiding_party",
    "method": "json",
    "object": { "remove_npcs": [ { "class": "pagan_cult_member_rescue", "x": [ 0, 23 ], "y": [ 0, 23 ] } ] }
  },
  {
    "type": "mapgen",
    "update_mapgen_id": "valhallist_remove_slaves",
    "method": "json",
    "object": { "remove_npcs": [ { "class": "hells_raiders_slave", "x": [ 0, 23 ], "y": [ 0, 23 ] } ] }
  },
  {
    "//": "A catch-all background distribution group for the Valhallists.  Eventually, these should be implemented with the standard background trait groups.",
    "type": "trait_group",
    "id": "BG_survival_story_VALHALLIST",
    "subtype": "distribution",
    "traits": [ { "trait": "BGSS_Valhallist_AgSci" }, { "trait": "BGSS_FEMA_Evacuee_1" } ]
  },
  {
    "//": "A catch-all religious distribution group for the Valhallists.  Eventually, these could tie in with other NPCs.",
    "type": "trait_group",
    "id": "BG_religion_VALHALLIST",
    "subtype": "distribution",
    "traits": [ { "trait": "BGR_Asatro" }, { "trait": "BGR_Atheistic" } ]
  },
  {
    "type": "mutation",
    "id": "BGSS_Valhallist_AgSci",
    "name": { "str": "Survivor Story" },
    "points": 0,
    "description": "This NPC could tell you about how they survived the Cataclysm.",
    "player_display": false,
    "valid": false,
    "purifiable": false,
    "types": [ "BACKGROUND_SURVIVAL_STORY" ],
    "flags": [ "BG_SURVIVAL_STORY" ]
  },
  {
    "type": "mutation",
    "id": "BGR_Asatro",
    "name": { "str": "Survivor Religion" },
    "points": 0,
    "description": "This NPC could tell you about their religious affiliation.",
    "player_display": false,
    "valid": false,
    "purifiable": false,
    "types": [ "BACKGROUND_SURVIVAL_STORY" ],
    "flags": [ "BG_SURVIVAL_STORY" ]
  },
  {
    "type": "mutation",
    "id": "BGR_Atheistic",
    "name": { "str": "Survivor Religion" },
    "points": 0,
    "description": "This NPC could tell you about their religious affiliation.",
    "player_display": false,
    "valid": false,
    "purifiable": false,
    "types": [ "BACKGROUND_SURVIVAL_STORY" ],
    "flags": [ "BG_SURVIVAL_STORY" ]
  },
  {
    "type": "overmap_special",
    "id": "valhalla_cult",
    "overmaps": [
      { "point": [ 0, 0, 0 ], "overmap": "valhallist_henge_north" },
      { "point": [ -1, 0, 0 ], "overmap": "valhallist_long_wall_north" },
      { "point": [ 1, 0, 0 ], "overmap": "valhallist_long_wall_south" },
      { "point": [ 0, -1, 0 ], "overmap": "valhallist_longhouse_north" },
      { "point": [ 0, 1, 0 ], "overmap": "valhallist_enter_north" },
      { "point": [ 1, -1, 0 ], "overmap": "valhallist_right_corner_up_north" },
      { "point": [ -1, -1, 0 ], "overmap": "valhallist_left_corner_up_north" },
      { "point": [ 1, 1, 0 ], "overmap": "valhallist_right_corner_north" },
      { "point": [ -1, 1, 0 ], "overmap": "valhallist_left_corner_north" }
    ],
    "locations": [ "land" ],
    "city_distance": [ 5, 10 ],
    "occurrences": [ 90, 100 ],
    "eoc": { "id": "EOC_VALHALLA_CULT_GENERATE", "condition": { "days_since_cataclysm": 30 } },
    "flags": [ "CLASSIC", "GLOBALLY_UNIQUE", "SAFE_AT_WORLDGEN", "MAN_MADE" ]
  },
  {
    "type": "overmap_terrain",
    "id": [
      "valhallist_enter",
      "valhallist_right_corner",
      "valhallist_left_corner",
      "valhallist_right_corner_up",
      "valhallist_left_corner_up",
      "valhallist_long_wall",
      "valhallist_longhouse",
      "valhallist_henge"
    ],
    "name": "fortress",
    "sym": "W",
    "color": "brown",
    "see_cost": 5,
    "mondensity": 1
  }
]
